"lang"
{
"Language"	"dutch"
"Tokens"
{
"aghanim_bonus_round_time_left"	"RESTERENDE TIJD"
"[english]aghanim_bonus_round_time_left"	"TIME LEFT"
"DOTA_HUD_EnemiesRemaining"	"RESTERENDE VIJANDEN:"
"[english]DOTA_HUD_EnemiesRemaining"	"ENEMIES REMAINING:"
"DOTA_HUD_TimeRemaining"	"RESTERENDE TIJD:"
"[english]DOTA_HUD_TimeRemaining"	"TIME REMAINING:"
"DOTA_HUD_Bags"	"ZAKKEN"
"[english]DOTA_HUD_Bags"	"BAGS"
"DOTA_HUD_Mute"	"DEMPEN"
"[english]DOTA_HUD_Mute"	"MUTE"
"DOTA_HUD_PlayAgain"	"Opnieuw spelen?"
"[english]DOTA_HUD_PlayAgain"	"Play Again?"
"DOTA_HUD_Yes"	"JA"
"[english]DOTA_HUD_Yes"	"YES"
"DOTA_HUD_No"	"NEE"
"[english]DOTA_HUD_No"	"NO"
"DOTA_HUD_Score"	"SCORE"
"[english]DOTA_HUD_Score"	"SCORE"
"DOTA_HUD_RoomRewards"	"Kamerbeloningen"
"[english]DOTA_HUD_RoomRewards"	"Room Rewards"
"DOTA_HUD_Reward_Header"	"Kies je beloning"
"[english]DOTA_HUD_Reward_Header"	"Choose your reward"
"DOTA_HUD_Reward_Gold"	"Bonusgoud"
"[english]DOTA_HUD_Reward_Gold"	"Bonus Gold"
"DOTA_HUD_Reward_Gold_desc"	"{d:quantity} goud"
"[english]DOTA_HUD_Reward_Gold_desc"	"{d:quantity} Gold"
"DOTA_HUD_Reward_ExtraLives"	"Extra leven(s)"
"[english]DOTA_HUD_Reward_ExtraLives"	"Extra Live(s)"
"DOTA_HUD_Reward_ExtraLives_desc"	"{d:quantity} extra leven"
"[english]DOTA_HUD_Reward_ExtraLives_desc"	"{d:quantity} Extra Life"
"DOTA_HUD_Reward_Item"	"Neutraal item"
"[english]DOTA_HUD_Reward_Item"	"Neutral Item"
"DOTA_HUD_Reward_TempBuff"	"Tijdelijke buff"
"[english]DOTA_HUD_Reward_TempBuff"	"Temp Buff"
"DOTA_HUD_Reward_Aura"	"Aura"
"[english]DOTA_HUD_Reward_Aura"	"Aura"
"DOTA_HUD_Reward_MinotrAbilityUpgrade"	"Vaardigheidsupgrade"
"[english]DOTA_HUD_Reward_MinotrAbilityUpgrade"	"Ability Upgrade"
"DOTA_HUD_TopBar_Difficulty"	"{s:difficulty_name}"
"[english]DOTA_HUD_TopBar_Difficulty"	"{s:difficulty_name}"
"DOTA_HUD_BattleRoyaleDamageStarting"	"Terug naar de strijd, lafaard!"
"[english]DOTA_HUD_BattleRoyaleDamageStarting"	"Join the battle, coward!"
"DOTA_RewardTooltip_Gold"	"Goud"
"[english]DOTA_RewardTooltip_Gold"	"Gold"
"DOTA_RewardTooltip_XP"	"XP"
"[english]DOTA_RewardTooltip_XP"	"XP"
"DOTA_HUD_REWARD_TYPE_GOLD_Toast"	"{s:player_name} heeft {d:int_value} gekozen <panel class='CombatEventGoldIcon'/>"
"[english]DOTA_HUD_REWARD_TYPE_GOLD_Toast"	"{s:player_name} chose {d:int_value} <panel class='CombatEventGoldIcon'/>"
"DOTA_HUD_REWARD_TYPE_ITEM_Toast"	"{s:player_name} heeft {s:locstring_value} gekozen"
"[english]DOTA_HUD_REWARD_TYPE_ITEM_Toast"	"{s:player_name} chose {s:locstring_value}"
"DOTA_HUD_REWARD_TYPE_ABILITY_UPGRADE_Toast"	"{s:player_name} heeft {s:locstring_value} gekozen"
"[english]DOTA_HUD_REWARD_TYPE_ABILITY_UPGRADE_Toast"	"{s:player_name} chose {s:locstring_value}"
"DOTA_HUD_REWARD_TYPE_EXTRA_LIVES_Toast"	"{s:player_name} heeft {d:int_value} gekozen"
"[english]DOTA_HUD_REWARD_TYPE_EXTRA_LIVES_Toast"	"{s:player_name} chose {d:int_value}"
"DOTA_HUD_REWARD_TYPE_MINOR_ABILITY_UPGRADE_Toast"	"{s:player_name} heeft %s1 gekozen"
"[english]DOTA_HUD_REWARD_TYPE_MINOR_ABILITY_UPGRADE_Toast"	"{s:player_name} chose %s1"
"DOTA_HUD_REWARD_TYPE_MINOR_STATS_UPGRADE_Toast"	"{s:player_name} heeft %s1 gekozen"
"[english]DOTA_HUD_REWARD_TYPE_MINOR_STATS_UPGRADE_Toast"	"{s:player_name} chose %s1"
"DOTA_HUD_REWARD_TYPE_GOLD_Desc"	"Goud"
"[english]DOTA_HUD_REWARD_TYPE_GOLD_Desc"	"Gold"
"DOTA_HUD_REWARD_TYPE_TREASURE_Desc"	"Schatkist"
"[english]DOTA_HUD_REWARD_TYPE_TREASURE_Desc"	"Treasure Chest"
"DOTA_HUD_REWARD_TYPE_EXTRA_LIVES_Desc"	"Extra levens"
"[english]DOTA_HUD_REWARD_TYPE_EXTRA_LIVES_Desc"	"Extra Lives"
"DOTA_HUD_Claimed_Rewards_Header"	"Opgeëiste beloningen"
"[english]DOTA_HUD_Claimed_Rewards_Header"	"Claimed Rewards"
"DOTA_Hud_Tooltip_Outpost_TrapTitle"	"Val"
"[english]DOTA_Hud_Tooltip_Outpost_TrapTitle"	"Trap"
"DOTA_Hud_Tooltip_Outpost_BonusTitle"	"Bonus"
"[english]DOTA_Hud_Tooltip_Outpost_BonusTitle"	"Bonus"
"npc_dota_creature_ogre_tank"	"Bonemeal Tank"
"[english]npc_dota_creature_ogre_tank"	"Bonemeal Tank"
"npc_dota_holdout_tower"	"Uitkijktoren"
"[english]npc_dota_holdout_tower"	"Watchtower"
"npc_dota_creature_friendly_baby_ogre_tank"	"Blug"
"[english]npc_dota_creature_friendly_baby_ogre_tank"	"Blug"
"npc_dota_creature_friendly_ogre_seal"	"Gary"
"[english]npc_dota_creature_friendly_ogre_seal"	"Gary"
"npc_dota_creature_storegga"	"Storegga"
"[english]npc_dota_creature_storegga"	"Storegga"
"npc_aghsfort_morty"	"Marty"
"[english]npc_aghsfort_morty"	"Marty"
"npc_dota_creature_fire_roshan"	"Blazhan"
"[english]npc_dota_creature_fire_roshan"	"Blazhan"
"npc_dota_creature_baby_roshan"	"Roshling"
"[english]npc_dota_creature_baby_roshan"	"Roshling"
"npc_dota_creature_ogre_tank_boss"	"Bogdugg"
"[english]npc_dota_creature_ogre_tank_boss"	"Bogdugg"
"npc_aghsfort_creature_wave_blaster_ghost"	"Ice Spirit"
"[english]npc_aghsfort_creature_wave_blaster_ghost"	"Ice Spirit"
"npc_dota_creature_drow_ranger_miniboss"	"Deadeye"
"[english]npc_dota_creature_drow_ranger_miniboss"	"Deadeye"
"npc_dota_creature_sheep_hostage"	"Schaap"
"[english]npc_dota_creature_sheep_hostage"	"Sheep"
"npc_dota_creature_gladiator_creep"	"Amateur"
"[english]npc_dota_creature_gladiator_creep"	"Amateur"
"npc_dota_creature_tidehunter_mini"	"Beach Comber"
"[english]npc_dota_creature_tidehunter_mini"	"Beach Comber"
"npc_dota_creature_tidehunter_large"	"Ocean Guide"
"[english]npc_dota_creature_tidehunter_large"	"Ocean Guide"
"npc_dota_boss_timbersaw"	"Rizzrick"
"[english]npc_dota_boss_timbersaw"	"Rizzrick"
"DOTA_Tooltip_ability_item_satanic_bonus_strength"	"+$str"
"[english]DOTA_Tooltip_ability_item_satanic_bonus_strength"	"+$str"
"DOTA_Tooltip_ability_item_satanic_bonus_damage"	"+$damage"
"[english]DOTA_Tooltip_ability_item_satanic_bonus_damage"	"+$damage"
"DOTA_Tooltip_Ability_aghanim_empty_spell1"	"Vaardigheid vergrendeld"
"[english]DOTA_Tooltip_Ability_aghanim_empty_spell1"	"Ability Locked"
"DOTA_Tooltip_Ability_aghanim_empty_spell2"	"Vaardigheid vergrendeld"
"[english]DOTA_Tooltip_Ability_aghanim_empty_spell2"	"Ability Locked"
"DOTA_Tooltip_Ability_aghanim_empty_spell3"	"Vaardigheid vergrendeld"
"[english]DOTA_Tooltip_Ability_aghanim_empty_spell3"	"Ability Locked"
"DOTA_Tooltip_Ability_aghanim_empty_spell4"	"Vaardigheid vergrendeld"
"[english]DOTA_Tooltip_Ability_aghanim_empty_spell4"	"Ability Locked"
"DOTA_Tooltip_modifier_aghanim_spell_swap"	"Vaardigheid vergrendeld"
"[english]DOTA_Tooltip_modifier_aghanim_spell_swap"	"Ability Locked"
"DOTA_Tooltip_ability_creature_brewmaster_fire_permanent_immolation_Lore"	""
"[english]DOTA_Tooltip_ability_creature_brewmaster_fire_permanent_immolation_Lore"	""
"DOTA_Tooltip_ability_creature_brewmaster_fire_permanent_immolation_damage"	"SCHADE PER SECONDE:"
"[english]DOTA_Tooltip_ability_creature_brewmaster_fire_permanent_immolation_damage"	"DAMAGE PER SECOND:"
"DOTA_Tooltip_ability_creature_brewmaster_fire_permanent_immolation_radius"	"STRAAL:"
"[english]DOTA_Tooltip_ability_creature_brewmaster_fire_permanent_immolation_radius"	"RADIUS:"
"DOTA_Tooltip_Ability_item_greater_salve"	"Greater Salve"
"[english]DOTA_Tooltip_Ability_item_greater_salve"	"Greater Salve"
"DOTA_Tooltip_modifier_item_greater_salve"	"Greater Salve"
"[english]DOTA_Tooltip_modifier_item_greater_salve"	"Greater Salve"
"DOTA_Tooltip_ability_item_purification_potion_heal"	"GEZONDHEID/SCHADE:"
"[english]DOTA_Tooltip_ability_item_purification_potion_heal"	"HEAL/DAMAGE:"
"DOTA_Tooltip_ability_item_ravage_potion_radius"	"STRAAL:"
"[english]DOTA_Tooltip_ability_item_ravage_potion_radius"	"RADIUS:"
"DOTA_Tooltip_ability_item_ravage_potion_duration"	"DUUR:"
"[english]DOTA_Tooltip_ability_item_ravage_potion_duration"	"DURATION:"
"DOTA_Tooltip_ability_item_dragon_potion_duration"	"DUUR:"
"[english]DOTA_Tooltip_ability_item_dragon_potion_duration"	"DURATION:"
"DOTA_Tooltip_ability_item_dragon_potion_bonus_attack_range"	"BONUSAANVALSBEREIK:"
"[english]DOTA_Tooltip_ability_item_dragon_potion_bonus_attack_range"	"BONUS ATTACK RANGE:"
"DOTA_Tooltip_ability_item_dragon_potion_bonus_attack_damage"	"BONUSSCHADE:"
"[english]DOTA_Tooltip_ability_item_dragon_potion_bonus_attack_damage"	"BONUS DAMAGE:"
"DOTA_Tooltip_ability_item_dragon_potion_magic_resistance"	"MAGIEWEERSTAND:"
"[english]DOTA_Tooltip_ability_item_dragon_potion_magic_resistance"	"MAGIC RESISTANCE:"
"DOTA_Tooltip_ability_item_arcanist_potion_duration"	"DUUR:"
"[english]DOTA_Tooltip_ability_item_arcanist_potion_duration"	"DURATION:"
"DOTA_Tooltip_ability_item_echo_slam_potion_echo_slam_damage_range"	"STRAAL:"
"[english]DOTA_Tooltip_ability_item_echo_slam_potion_echo_slam_damage_range"	"RADIUS:"
"DOTA_Tooltip_ability_item_torrent_effect_potion_stun_duration"	"VERLAMMINGSDUUR:"
"[english]DOTA_Tooltip_ability_item_torrent_effect_potion_stun_duration"	"STUN DURATION:"
"DOTA_Tooltip_ability_item_shadow_wave_effect_potion_cast_range"	"BEREIK:"
"[english]DOTA_Tooltip_ability_item_shadow_wave_effect_potion_cast_range"	"RANGE:"
"DOTA_Tooltip_ability_item_shadow_wave_effect_potion_damage"	"GEZONDHEID/SCHADE:"
"[english]DOTA_Tooltip_ability_item_shadow_wave_effect_potion_damage"	"HEAL/DAMAGE:"
"DOTA_Tooltip_modifier_ascension_damage"	"Dodelijk"
"[english]DOTA_Tooltip_modifier_ascension_damage"	"Deadly"
"DOTA_Tooltip_modifier_ascension_magic_immunity"	"Avatar"
"[english]DOTA_Tooltip_modifier_ascension_magic_immunity"	"Avatar"
"DOTA_Tooltip_modifier_ascension_extra_fast"	"Surge"
"[english]DOTA_Tooltip_modifier_ascension_extra_fast"	"Surge"
"DOTA_Tooltip_ability_aghsfort_luna_lucent_beam"	"Lucent Beam"
"[english]DOTA_Tooltip_ability_aghsfort_luna_lucent_beam"	"Lucent Beam"
"DOTA_Tooltip_ability_aghsfort_luna_lucent_beam_stun_duration"	"VERLAMMINGSDUUR:"
"[english]DOTA_Tooltip_ability_aghsfort_luna_lucent_beam_stun_duration"	"STUN DURATION:"
"DOTA_Tooltip_ability_aghsfort_luna_eclipse"	"Eclipse"
"[english]DOTA_Tooltip_ability_aghsfort_luna_eclipse"	"Eclipse"
"DOTA_Tooltip_ability_aghsfort_luna_eclipse_radius"	"STRAAL:"
"[english]DOTA_Tooltip_ability_aghsfort_luna_eclipse_radius"	"RADIUS:"
"DOTA_Tooltip_ability_aghsfort_luna_eclipse_beams_scepter"	"SCEPTER - STRALEN:"
"[english]DOTA_Tooltip_ability_aghsfort_luna_eclipse_beams_scepter"	"SCEPTER TOTAL BEAMS:"
"DOTA_Tooltip_ability_aghsfort_luna_eclipse_duration_tooltip_scepter"	"SCEPTER - DUUR:"
"[english]DOTA_Tooltip_ability_aghsfort_luna_eclipse_duration_tooltip_scepter"	"SCEPTER DURATION:"
"DOTA_Tooltip_ability_aghsfort_luna_eclipse_cast_range_tooltip_scepter"	"SCEPTER - SPREUKBEREIK:"
"[english]DOTA_Tooltip_ability_aghsfort_luna_eclipse_cast_range_tooltip_scepter"	"SCEPTER CAST RANGE:"
"DOTA_Tooltip_ability_item_creed_of_omniscience_bonus_xp"	"%BONUS-XP:"
"[english]DOTA_Tooltip_ability_item_creed_of_omniscience_bonus_xp"	"%BONUS XP:"
"DOTA_Tooltip_ability_item_pelt_of_the_old_wolf_Description"	""
"[english]DOTA_Tooltip_ability_item_pelt_of_the_old_wolf_Description"	""
"DOTA_Tooltip_ability_item_pelt_of_the_old_wolf_bonus_armor"	"BONUSPANTSER:"
"[english]DOTA_Tooltip_ability_item_pelt_of_the_old_wolf_bonus_armor"	"BONUS ARMOR:"
"DOTA_Tooltip_ability_item_longclaws_amulet_Description"	""
"[english]DOTA_Tooltip_ability_item_longclaws_amulet_Description"	""
"DOTA_Tooltip_ability_item_bogduggs_cudgel_bonus_damage"	"BONUSSCHADE:"
"[english]DOTA_Tooltip_ability_item_bogduggs_cudgel_bonus_damage"	"BONUS DAMAGE:"
"DOTA_Tooltip_ability_item_bogduggs_baldric_Description"	""
"[english]DOTA_Tooltip_ability_item_bogduggs_baldric_Description"	""
"DOTA_Tooltip_ability_item_bogduggs_baldric_bonus_armor"	"BONUSPANTSER:"
"[english]DOTA_Tooltip_ability_item_bogduggs_baldric_bonus_armor"	"BONUS ARMOR:"
"DOTA_Tooltip_ability_item_bogduggs_lucky_femur_Lore"	"En nog eentje!"
"[english]DOTA_Tooltip_ability_item_bogduggs_lucky_femur_Lore"	"And another!"
"DOTA_Tooltip_ability_item_sign_of_the_arachnid_bonus_agility"	"BONUSBEHENDIGHEID:"
"[english]DOTA_Tooltip_ability_item_sign_of_the_arachnid_bonus_agility"	"BONUS AGILITY:"
"DOTA_Tooltip_ability_item_rhyziks_eye_Description"	""
"[english]DOTA_Tooltip_ability_item_rhyziks_eye_Description"	""
"DOTA_Tooltip_ability_item_rhyziks_eye_bonus_damage_pct"	"%BONUSSCHADE:"
"[english]DOTA_Tooltip_ability_item_rhyziks_eye_bonus_damage_pct"	"%BONUS DAMAGE:"
"DOTA_Tooltip_ability_item_guardian_shell_bonus_armor"	"BONUSPANTSER:"
"[english]DOTA_Tooltip_ability_item_guardian_shell_bonus_armor"	"BONUS ARMOR:"
"DOTA_Tooltip_ability_item_guardian_shell_magic_resistance"	"%BONUSMAGIEWEERSTAND:"
"[english]DOTA_Tooltip_ability_item_guardian_shell_magic_resistance"	"%BONUS MAGIC RESISTANCE:"
"DOTA_Tooltip_ability_item_carapace_of_qaldin_bonus_hp"	"BONUS-HP:"
"[english]DOTA_Tooltip_ability_item_carapace_of_qaldin_bonus_hp"	"BONUS HP:"
"DOTA_Tooltip_ability_item_carapace_of_qaldin_bonus_mana"	"BONUSMANA:"
"[english]DOTA_Tooltip_ability_item_carapace_of_qaldin_bonus_mana"	"BONUS MANA:"
"DOTA_Tooltip_ability_item_the_caustic_finale_bonus_damage"	"BONUSSCHADE:"
"[english]DOTA_Tooltip_ability_item_the_caustic_finale_bonus_damage"	"BONUS DAMAGE:"
"DOTA_Tooltip_ability_item_winter_embrace_bonus_armor"	"BONUSPANTSER:"
"[english]DOTA_Tooltip_ability_item_winter_embrace_bonus_armor"	"BONUS ARMOR:"
"DOTA_Tooltip_ability_item_ice_dragon_maw_bonus_damage"	"BONUSSCHADE:"
"[english]DOTA_Tooltip_ability_item_ice_dragon_maw_bonus_damage"	"BONUS DAMAGE:"
"DOTA_Tooltip_ability_item_stony_coat_bonus_armor"	"BONUSPANTSER:"
"[english]DOTA_Tooltip_ability_item_stony_coat_bonus_armor"	"BONUS ARMOR:"
"DOTA_Tooltip_ability_item_gravel_foot_Description"	""
"[english]DOTA_Tooltip_ability_item_gravel_foot_Description"	""
"DOTA_Tooltip_Ability_item_wand_of_the_brine_bonus_intelligence"	"+$int"
"[english]DOTA_Tooltip_Ability_item_wand_of_the_brine_bonus_intelligence"	"+$int"
"DOTA_Tooltip_Ability_item_wand_of_the_brine_bonus_mana_regen_pct"	"%+$mana_regen"
"[english]DOTA_Tooltip_Ability_item_wand_of_the_brine_bonus_mana_regen_pct"	"%+$mana_regen"
"DOTA_Tooltip_modifier_item_wand_of_the_brine_bubble"	"Brinefoam"
"[english]DOTA_Tooltip_modifier_item_wand_of_the_brine_bubble"	"Brinefoam"
"DOTA_Tooltip_Ability_item_slippers_of_the_abyss_bonus_strength"	"+$str"
"[english]DOTA_Tooltip_Ability_item_slippers_of_the_abyss_bonus_strength"	"+$str"
"DOTA_Tooltip_Ability_item_slippers_of_the_abyss_bonus_agility"	"+$agi"
"[english]DOTA_Tooltip_Ability_item_slippers_of_the_abyss_bonus_agility"	"+$agi"
"DOTA_Tooltip_Ability_item_glimmerdark_shield_bonus_strength"	"+$str"
"[english]DOTA_Tooltip_Ability_item_glimmerdark_shield_bonus_strength"	"+$str"
"DOTA_Tooltip_Ability_item_glimmerdark_shield_bonus_agility"	"+$agi"
"[english]DOTA_Tooltip_Ability_item_glimmerdark_shield_bonus_agility"	"+$agi"
"DOTA_Tooltip_Ability_item_glimmerdark_shield_bonus_intellect"	"+$int"
"[english]DOTA_Tooltip_Ability_item_glimmerdark_shield_bonus_intellect"	"+$int"
"DOTA_Tooltip_Ability_item_glimmerdark_shield_bonus_armor"	"BONUSPANTSER:"
"[english]DOTA_Tooltip_Ability_item_glimmerdark_shield_bonus_armor"	"BONUS ARMOR:"
"DOTA_Tooltip_modifier_item_glimmerdark_shield_prism"	"Gleam"
"[english]DOTA_Tooltip_modifier_item_glimmerdark_shield_prism"	"Gleam"
"DOTA_Tooltip_Ability_item_dredged_trident_bonus_damage"	"+$damage"
"[english]DOTA_Tooltip_Ability_item_dredged_trident_bonus_damage"	"+$damage"
"DOTA_Tooltip_Ability_item_ambient_sorcery_bonus_intelligence"	"+$int"
"[english]DOTA_Tooltip_Ability_item_ambient_sorcery_bonus_intelligence"	"+$int"
"DOTA_Tooltip_Ability_item_ogre_seal_totem_bonus_hp"	"BONUS-HP:"
"[english]DOTA_Tooltip_Ability_item_ogre_seal_totem_bonus_hp"	"BONUS HP:"
"DOTA_Tooltip_Ability_item_lifestone"	"Lifestone"
"[english]DOTA_Tooltip_Ability_item_lifestone"	"Lifestone"
"DOTA_Tooltip_Ability_item_lifestone_hp_regen"	"HP-HERSTEL:"
"[english]DOTA_Tooltip_Ability_item_lifestone_hp_regen"	"HP REGEN:"
"DOTA_Tooltip_Ability_item_corrupting_blade_bonus_damage"	"+$damage"
"[english]DOTA_Tooltip_Ability_item_corrupting_blade_bonus_damage"	"+$damage"
"DOTA_Tooltip_Ability_item_amorphotic_shell_bonus_agility"	"BONUSBEHENDIGHEID:"
"[english]DOTA_Tooltip_Ability_item_amorphotic_shell_bonus_agility"	"BONUS AGILITY:"
"DOTA_Tooltip_ability_aghsfort_aura_reward_hp_bonus_hp"	"%BONUS-HP:"
"[english]DOTA_Tooltip_ability_aghsfort_aura_reward_hp_bonus_hp"	"%BONUS HP:"
"DOTA_Tooltip_ability_aghsfort_aura_reward_armor_bonus_armor"	"BONUSPANTSER:"
"[english]DOTA_Tooltip_ability_aghsfort_aura_reward_armor_bonus_armor"	"BONUS ARMOR:"
"DOTA_Tooltip_ability_aghsfort_aura_reward_magic_resist_bonus_magical_armor"	"MAGIEWEERSTAND:"
"[english]DOTA_Tooltip_ability_aghsfort_aura_reward_magic_resist_bonus_magical_armor"	"MAGIC RESISTANCE:"
"DOTA_Tooltip_modifier_urn_upheaval_Description"	"Bewegingssnelheid is enorm verlaagd."
"[english]DOTA_Tooltip_modifier_urn_upheaval_Description"	"Movement speed is greatly reduced."
"DOTA_Subshop_3"	"Fragmenten"
"[english]DOTA_Subshop_3"	"Shards"
"DOTA_Subshop_npc_dota_hero_disruptor"	"Disruptor"
"[english]DOTA_Subshop_npc_dota_hero_disruptor"	"Disruptor"
"DOTA_Subshop_npc_dota_hero_magnataur"	"Magnus"
"[english]DOTA_Subshop_npc_dota_hero_magnataur"	"Magnus"
"DOTA_Subshop_npc_dota_hero_mars"	"Mars"
"[english]DOTA_Subshop_npc_dota_hero_mars"	"Mars"
"DOTA_Subshop_npc_dota_hero_omniknight"	"Omniknight"
"[english]DOTA_Subshop_npc_dota_hero_omniknight"	"Omniknight"
"DOTA_Subshop_npc_dota_hero_queenofpain"	"Queen of Pain"
"[english]DOTA_Subshop_npc_dota_hero_queenofpain"	"Queen of Pain"
"DOTA_Subshop_npc_dota_hero_slark"	"Slark"
"[english]DOTA_Subshop_npc_dota_hero_slark"	"Slark"
"DOTA_Subshop_npc_dota_hero_snapfire"	"Snapfire"
"[english]DOTA_Subshop_npc_dota_hero_snapfire"	"Snapfire"
"DOTA_Subshop_npc_dota_hero_sniper"	"Sniper"
"[english]DOTA_Subshop_npc_dota_hero_sniper"	"Sniper"
"DOTA_Subshop_npc_dota_hero_templar_assassin"	"Templar Assassin"
"[english]DOTA_Subshop_npc_dota_hero_templar_assassin"	"Templar Assassin"
"DOTA_Subshop_npc_dota_hero_tusk"	"Tusk"
"[english]DOTA_Subshop_npc_dota_hero_tusk"	"Tusk"
"DOTA_Subshop_npc_dota_hero_ursa"	"Ursa"
"[english]DOTA_Subshop_npc_dota_hero_ursa"	"Ursa"
"DOTA_Subshop_npc_dota_hero_viper"	"Viper"
"[english]DOTA_Subshop_npc_dota_hero_viper"	"Viper"
"DOTA_Subshop_npc_dota_hero_weaver"	"Weaver"
"[english]DOTA_Subshop_npc_dota_hero_weaver"	"Weaver"
"DOTA_Subshop_npc_dota_hero_winter_wyvern"	"Winter Wyvern"
"[english]DOTA_Subshop_npc_dota_hero_winter_wyvern"	"Winter Wyvern"
"DOTA_Subshop_npc_dota_hero_witch_doctor"	"Witch Doctor"
"[english]DOTA_Subshop_npc_dota_hero_witch_doctor"	"Witch Doctor"
}
}
